//MAP CONVERTED BY dmm2tgm.py THIS HEADER COMMENT PREVENTS RECONVERSION, DO NOT REMOVE
"a" = (
/turf/open/void/vehicle,
/area/space)
"b" = (
/obj/structure/extinguisher_cabinet/lifeboat{
	icon = 'icons/obj/vehicles/interiors/general.dmi';
	pixel_x = -19;
	pixel_y = 14
	},
/obj/effect/landmark/interior/spawn/vehicle_driver_seat/armor/humvee{
	dir = 4;
	pixel_x = -3;
	pixel_y = 1;
	buckling_x = -3;
	buckling_y = 1
	},
/obj/effect/landmark/interior/spawn/entrance{
	dir = 4;
	exit_type = /obj/structure/interior_exit/vehicle/humvee/left;
	name = "left entrance marker";
	tag = "left";
	pixel_x = -3;
	pixel_y = 14;
	icon = 'icons/obj/vehicles/interiors/general_humvee.dmi';
	icon_state = "exit_door1";
	layer = 2.8
	},
/obj/effect/landmark/interior/spawn/interior_viewport/humvee{
	pixel_x = -3;
	pixel_y = 16
	},
/turf/open/shuttle/vehicle,
/area/interior/vehicle/humvee/transport)
"p" = (
/obj/effect/landmark/interior/spawn/interior_viewport/humvee{
	icon_state = "viewport_frontwindow_south";
	pixel_x = -10;
	pixel_y = 7
	},
/turf/open/void/vehicle,
/area/space)
"v" = (
/obj/structure/bed/chair/comfy/vehicle/passager{
	dir = 4;
	pixel_y = 5;
	buckling_y = 5;
	pixel_x = -3;
	buckling_x = -3
	},
/obj/effect/landmark/interior/spawn/entrance{
	alpha = 75;
	exit_type = /obj/structure/interior_exit/vehicle/humvee/right;
	name = "right entrance marker";
	tag = "right";
	pixel_x = -3;
	pixel_y = -10;
	icon = 'icons/obj/vehicles/interiors/general_humvee.dmi';
	icon_state = "exit_door";
	layer = 5.22
	},
/obj/effect/landmark/interior/spawn/interior_viewport/humvee{
	pixel_x = -3;
	pixel_y = -8;
	layer = 5.23;
	alpha = 150
	},
/turf/open/shuttle/vehicle,
/area/interior/vehicle/humvee/transport)
"F" = (
/obj/effect/landmark/interior/spawn/interior_viewport/humvee{
	icon_state = "viewport_frontwindow_north";
	pixel_x = -10;
	pixel_y = 5
	},
/turf/open/void/vehicle,
/area/space)
"L" = (
/obj/effect/landmark/interior/spawn/entrance{
	dir = 8;
	exit_type = /obj/structure/interior_exit/vehicle/humvee/back/left;
	name = "back left entrance marker";
	pixel_x = -31;
	tag = "back left";
	icon_state = "carrier_backdoor1";
	icon = 'icons/obj/vehicles/interiors/general_humvee.dmi'
	},
/turf/open/shuttle/vehicle,
/area/interior/vehicle/humvee/transport)
"M" = (
/obj/effect/landmark/interior/spawn/entrance{
	dir = 8;
	exit_type = /obj/structure/interior_exit/vehicle/humvee/back/right;
	name = "back right entrance marker";
	pixel_x = -31;
	tag = "back right";
	icon_state = "carrier_backdoor2";
	icon = 'icons/obj/vehicles/interiors/general_humvee.dmi'
	},
/obj/structure/prop/vehicle/humvee/requisition{
	pixel_x = -8;
	pixel_y = -12
	},
/turf/open/shuttle/vehicle,
/area/interior/vehicle/humvee/transport)
"T" = (
/obj/effect/landmark/interior/spawn/interior_viewport/humvee{
	icon_state = "small_viewport";
	pixel_x = -1;
	pixel_y = -7;
	alpha = 150
	},
/turf/open/shuttle/vehicle,
/area/interior/vehicle/humvee/transport)
"U" = (
/obj/effect/landmark/interior/spawn/interior_viewport/humvee{
	icon_state = "small_viewport";
	pixel_x = -1;
	pixel_y = 17;
	layer = 3
	},
/turf/open/shuttle/vehicle,
/area/interior/vehicle/humvee/transport)

(1,1,1) = {"
a
a
a
a
"}
(2,1,1) = {"
a
L
M
a
"}
(3,1,1) = {"
a
U
T
a
"}
(4,1,1) = {"
a
b
v
a
"}
(5,1,1) = {"
a
F
p
a
"}
